5555555555555555555555555555555555555555
5021023210000102102012310130220330103105
5013310303112210020032210103332122031205
5313313121220212000030000323221322313115
5203313223033111002332231111022032122305
5102012001232330032033200011330020200315
5300331003033130012322023022212213010115
5122322330231100000030121302132022323135
5210023103210000038121102013310010030225
5022320013320300000022031313312032110315
5102332222101040300300313330313310231325
5122320122210213300300332301200013322205
5112101011001001232303023123010211121105
5022110321102332001001023330221131220115
5130313103303310320202033332013233111305
5303220303133022021310030003302100013225
5122103103233320213002303122000332031335
5303200233329132220011001131203333312015
5331001100120030211023303231132101200015
5310210322302102330011121213303002300315
5013103003331323333232313210101332101215
5213130122111121211112312033301133033235
5223132122320200212300101300311013030225
5201333200222231332010210210303021122235
5555555555555555555555555555555555555555
